Esa Pakarinen - Lentävä kalakukko
Washboard Sam - Bucket's Got A Hole In It
Billy Higgins - Peace
Bill & Gloria Gaither - Holy Ground (Homecoming Hymns Version)
Hank Penny & The Lincoln Penny Orchestra - Dixie
Kaskaad - Mohawk Hunt
Small Faces - My Mind's Eye
Sleepy John Estes - Street Car Blues
Aesop Rock - No City - Instrumental
Bad Brains - At The Atlantis
Yuridia - Sin Ti
Weezer - Don't Let Go
George Lopez - Vibrators
Los Del Rio_ The D.E.Y. - Mi Gitana (feat. The Dey)
Stone Temple Pilots - Down (LP Version)
Gary Nichols - Paper Doll
Bill & Gloria Gaither - Awesome God
Wilmington Chester Mass Choir - Lord You're Worthy (Album)
Frank Ifield - Give Me Your Word
James Darren - P.S. I Love You (LP Version)
Morel - Blue Taxi
Rita Chiarelli - Reginella
Wilks - Still feel pain
The Roches - It's Bad For Me (Album Version)
Naughty By Nature - Family Tree
LL Cool J - Headsprung
Frankee - Gotta Man
The Hollywood Brats - Empty Bottles
Marc Perrone - La marine
Bobby Pulido - Mi Corazón Y Mi Mente
Canis Dirus - A Somber Wind from a Distant Shore (Album)
Kevin Burke - Brendan McGlinchey's Reel (Splendid Isolation) / Sweeney's Buttermilk (medley)
Rainer Bielfeldt - No more going home
John Pagano_ Burt Bacharach - I Still Remember
Stiff Meat - Lonely
Bebo & Cigala - Inolvidable
Malefaction - Drowning In Public Approval
Samy Deluxe - Die Meisten
The Vaughan Brothers - Hillbillies From Outerspace
Stephy Tang - Zi You Zi Zai
Studio - Indo
Der Plan - De Kommissar 1
Geier Sturzflug - Bruttosozialprodukt
Hevia - San Xuan
A.Z. - We Can't Win (Explicit)
Vrse Murphy - Cremona (Instrumental)
Tanto Metro & Devonte - Strange Things
Alexandre Desplat - Palmer enquête
Little Milton - My Way
The Cure - Primary
Blue Rodeo - Mystic River
Los Manolos - Rumba De Barcelona
Abraham Laboriel - Guidum
Steve Chou - Wo Men De Fei Leng Cui
The Pharcyde - Passin' Me By
Claire Elzière - Les frelons (Live)
Dexys Midnight Runners - Until I Believe In My Soul
Günter Noris - Tigerauge Rock
Delbert McClinton - Lose Your Money
Freedom - Caught - Special Way
Ivan Parker - Close To The Well (Live)
Faith Hill & Tim McGraw - Let's Make Love (Album Version)
Bitty McLean - We´ve Only Just Begun
Mike Vax - Trumpet Blues And Cantabile
Malkit Singh - Dhol Ton Bina
Josie - Heavy Heart (Album Version)
Alice Stuart - Kassie Jones
Earth - Thrones And Dominions (Album)
The Meatmen - We Didn't Kill Each Other (But Didn't We Try) [Originally Performed by Dallas Wayne]
Dario Marianelli - Why Did You All Lie to Me?
Tyrone Taylor - Got To Make Me Love You
Anthony Blea Y Su Charanga - Tumba Randy
Tom Petty And The Heartbreakers - Christmas All Over Again
Sugarbomb - Gone
Poncho Sanchez - Co Co My My
Lari White - The One Who Lives Inside Your Heart
Shunza - Dear Friend
Scott Matthews - City Headache
A Day To Remember - The Plot To Bomb The Panhandle (Album Version)
Renee Rosnes - Children's Song No. 3
Jane Winther - Deep Voices
Joe Grushecky - A Fool's Advice
Dan Shen_ Gruppo Vocale Cantemus_ Ensemble Airone_ Luigi Marzola - Miserere: IV. Quoniam Iniquitatem
DJ Spinn - Times Up
Christophe Beck - Why Jack Called
Dimmu Borgir - Puritania
Rick Snel - Metanoia
Len Barry - Dirty Old Man
Blingtones - Baby U Acting Greezy (Ringtone_ Sonnerie)
Metsatöll - Kui rebeneb taevas
Maria & Margot Hellwig/Die Garmischer Alpenjäger - Lieder_ Die Uns Ein Leben Lang Begleiten
Wailing Souls - Old Broom
Erik Berglund - Angel Of Heaven's Gate
Papa Wemba - Abu-Pia
Beenie Man - Cross The Bridge
Nora - The Power Of
Mobb Deep - Hell On Earth (Front Lines)
Ramesses - Unholy Outburst #3
Asleep At The Wheel - The Son Shines Down On Me
Steel Rain - Loaded Like A Gun
The Jeremy Spencer Band - Travellin' (Album Version)
Francis Dunnery - The Possibilities of Loving You
The Del McCoury Band - Led By the Master's Hand
Wednesday 13's Frankenstein Drag Queens From Planet 13 - 197666 w/ Special Guest The Confederate Crusader (Album Version)
Atman - Luminous Bliss
Fiona Sit - Xin Bu Liao Qing
Mississippi Mass Choir - It Came To Pass (Part II)
Eddie Cantor - That's The Kind Of Baby For Me
A Tribe Called Quest - Scenario
Freddie King - Boogie Man
The Cate Brothers - Let's Start All Over
Eason Chan - Fang Bu Sheng Fang
Cinder - Seven (Album)
Stephy Tang - Leng Jing
Cockney Rejects - Oi! Oi! Oi!
Zebra - The Ocean (Live Version)
Who Made Who - This Train (Munk Edit)
Atman - Dancing With the Goddess (ttt rmx)
Kurt Tepperwein - Subliminal ohne Naturgeraeusche
Northern State - Last Night
The Radio Department - I Don't Like It Like This
Usher - I'll Show You Love
Pascal Obispo - Tombé Pour Elle (L'Île Aux Oiseaux)
Workhorse - Flight of the Elephant
Aleks Syntek - In My Arms (Live Auditorio Nacional 08)
Gordon MacRae - Soliloquy (2001 Digital Remaster)
Jope Ruonansuu - Rant Kanaria
Sergio Dalma - Un Cachito De Ti
Orbit - Nice Ride
Serge Desaunay - La polka des grenouilles
Joe McBride - This Is How A Heart Breaks
Jaydee - Plastic Dreams
Mac McAnally - If You Hang Around Long Enough
Michael Bloomfield - You're Killing My Love
The Wilburns - Keep Walking
Spongebob Squarepants - Ripped Pants
Der Moderne Man - Sinnloz/ Anakonda (live)
Fever Ray - When I Grow Up
Uphill Battle - Thresh Hold
Adr Lavey - In The Name of the Father
D.O.W.N. - I Luv Dat Too
Martin Sexton - Glory Bound (LP Version)
The Black Crowes - Good Morning Captain
Deathstar - Decline Of the Western Civilization
Toby Love Feat. Girlz Talk - Yo Quiero Saber
Julie Roberts - The Chance
Johnny Pearson - Lets Go Amigos - Tail
Johnny Horton - The Golden Rocket
Mick Hucknall - I Love You More Than You'll Ever Know
John Fogerty - Soda Pop
I.N.T. - Big Sister
Gym Class Heroes - Sloppy Love Jingle_ Pt. 3 (Amended Album Version)
Non Phixion - Sleepwalkers
Dub Wiser - Atom x
Bobby Russell - Jingle Bell Rock
The Ataris - I Won't Spend Another Night Alone
Selena - Disco Medley (Live At Houston Astrodome)
Rainer Bielfeldt - Gewisse Leute
Eddy Raven - In A Letter To You (Digitally Remastered 98)
Willie Clancy - Double Jig: The Rolling Wave
Robert Palmer - Looking For Clues
Six Brown Brothers - Battery Acid
Rokia Traoré - Koronoko
The Steeles - On The Road To Emmaus
White Heart - Where The Thunder Roars (Tales Of Wonder Album Version)
Teenage Fanclub - I Don't Know
Ayo - Welcome Into My World
Jimmy Hughes - Neighbor_ Neighbor
Freddie King - Key To The Highway
Ionics - Roll Back The Rug
Faithless - Six
Bill Boyd's Cowboy Ramblers - I Can't Tame Wild Women
Sick Puppies - Deliverance
One Block Radius - All On Our Own
André Blot - Breiz Ma bro
Nerf Herder - Nervous Breakdown
Paul Carrack - I'm On Your Tail
Bizarre Inc - Miracle
Jeff And Sheri Easter - Loving By Heart
Triana Pura - Con el chacacha del tren (Cancíon por Rumba)
Los Iracundos - Deja El Ultimo Baile Para Mi (Lascia L'Ultimo Ballo Per Me)
Plies featuring Tank - You (featuring Tank) (Amended Album Version)
Ben Sidran - See You On The Other Side
Facto Delafe y las flores azules - Desde el este
Static-X - Love Dump (Demo Version)
The Chico Hamilton Quintet - Night Beat
Moonface - G G Kah
Smiley - Come On Shake My Feelin'
Wilshire - Special
Royal S - Personne Stop (feat. Nixon)
Francis Dunnery - The Ava Song
Singing Melody Feat. Robyn - Are You Home
Kitty Wells - This White Circle
Judas Iscariot - Babylon
Michael Jackson - Heaven Can Wait
Pascal Sangla - Une petite pause
Jean Corti - Madeleine (feat. Thomas Fersen)
DJ Ostkurve - Sailing
M - Je Suis Une Cigarette
Korn - Make Me Bad
Frank Chacksfield - Terry's Theme from Limelight
Evolution - My Own Way
Sunscreem - Perfect Motion
Jeff & Sheri Easter - There Is a Way
The Insects - Winds of Change
Charlie Byrd - How Insensitive
Belle and Sebastian - Like Dylan In The Movies
Regina Belle - You Are Everything
Orbital - Are We Here ?
Lyrics Born - Is It The Skin I'm In?
John Brown - The Scenic Route
Alex - Cumpagno 'e cella
Pagan Wanderer Lu - Knight -> King 4
Dimitri Tiomkin - Villagers Galloping To Battle
Darwin's Waiting Room - Feel So Stupid (Table 9)
Justin - Erica
Humanzi - Fix The Cracks
Michael Stanley Band - Bop Till You Drop
Broadcast - Downstream
Orbital - Adnans
Lesley Gore - It's My Party
Gertrudis - Carita De Rosa
Quinteto Violado - A Burrinha
Skeeter Davis - My Last Date (With You)
Ini Kamoze - Hole In The Pumpkin
The Box Tops - Neon Rainbow
Kitaro - Village Attack/ The Arrest
Hatiras & Slarta John - Spaced Invader (Ian Pooley Club Mix)
Willy DeVille - Louise
Suicidal Tendencies - Two-Sided Politics
Urge Overkill - Crackbabies
Beto Cuevas - Mentira
Mario Rosenstock - Mercedes Benz
Wordsworth feat. Adanita Ross - Don't Go (Produced by Frequency)
Orlando Pops Orchestra - El Manisero
Dionne Warwick - I've Been Loving You Too Long (LP Version)
The Lord Weird Slough Feg - The Spinward Marches
EPMD - Please Listen To My Demo
Pierre Boulez - Messiaen : Et exspecto resurrectionem mortuorum : IV "Ils ressusciteront_ glorieux_ avec un nom nouveau
Tina Ann - Rules of Attraction (Chris Cox)
Carlos Nuñez - A Costa De Galicia
Rui Da Silva - Lixuneanos (Original Mix)
Luiz Bonfa - A Brazilian in New York
DJ Isaac - Focus
Bukka White - Fixin' To Die Blues
James Carter - Dodo's Bounce
Jean Fauque - Off The Record
Mance Lipscomb - So Different Blues
NOFX - My Heart Is Yearning
Professor Longhair - Bald Head
Mart'nália - Cabide
Janice Vidal - Li Jia Chu Zou
Mariano Yanani - Stuck In A Moment You can't Get Out Of
The Jackson Southernaires - When We All Get To Heaven
Nana Caymmi - Lero Do Bolero
Rage Against The Machine - Kick Out The Jams
Free - Heartbreaker
Dave Alvin - Somewhere In Time
Edgar Bori - À l'arraché
Korpiklaani - Isku Pitkästä Ilosta
Dario Marianelli - Falling Apart
Rakim feat. Tracey Horton - Won't Be Long
X-Raided - Who's Tha Hoe?
DJ Taz - C.O.G. To The ATL
Beatnuts featuring Tony Touch - Cocotaso featuring Tony Touch
Cali - Sta giu' (feat. Dj Rockdrive)
Don Gibson - Release Me
Los Ninos De Sara - Lioraras
Baby Huey & The Baby Sitters - California Dreamin' (LP Version)
Fortitude - He's Alright (Album Version)
Marilyn Horne / Wiener Opernorchester / Henry Lewis - Mon coeur s'ouvre à ta voix
José Augusto;Catia Guimma - Tudo Que Você Quiser
Big Star - Watch The Sunrise [Live at Lafayette's Music Room_ Memphis_ TN_ January 1973]
R. Carlos Nakai - Voyagers - Improvisation 12
Arkona - Epilogue
DJ X-Change featuring DJ Omega - At the Club
The Grease Band - Willie And The Pig
Talib Kweli - Everything Man (Album Version)
Mae West - Little Bar Butterfly
Robert Palmer - Some Guys Have All The Luck
Hoods - Another Lesson (Album Version)
Styles P & The Evil Genius DJ Green Lantern - Shadows
Beyoncé feat. Slim Thug - Check On It
The Color Red - Cleansing
Catherine Howe - Freedom Enough (From Silent Mother Nature)
Aiden - Die Romantic [Live]
Simple Minds - Careful In Career
Madonna - Bedtime Story (Album Version)
The Field Mice - When Morning Comes To Town
Sandi Thom - Wounded Hearts
Cali - Dolorosa (Live)
Out Of The Grey - The One I've Been Waiting For (Diamond Days Album Version)
Benny Spellman - I Didn't Know
Bobby Hutcherson - Les Noirs Marchant (Rudy Van Gelder 24Bit Mastering) (2002 Digital Remaster)
Alex - What If
Elton Britt - Little Silver Bells
U2 - New York
Alfredo Gutiérrez - Linda mariposa
Negura Bunget - Al Doilea Om
Marlene Dietrich - A Guy What Takes His Time En Anglais
Yuko Kanzaki - Seikurabe (Karaoke)
Lisa Lisa & Cult Jam (featuring Full Force) - U Never Nu How Good U Had It
Mista - I'll Sweat You (LP Version)
Vic Chou - Ni De Ti Wen
Rockin' Dopsie_ Jr._ The Zydeco Twisters - Funky Butt
Agnostic Front - Rock Star
Shaman - Battle Of The Tom Tom
Ethel Merman - Small World
The Berzerker - Deform (live)
Salt The Wound - The Beginning
Seventh Day Slumber - Sabados
Jimmy Witherspoon - I'm Just Wonderin' Part 2
Gene Autry - Cool Water
Lonnie Johnson - Raining On The Cold_ Cold Ground
Barbara Fairchild - Boulevard In Heaven
Jimmy Durante - Amen (Album Version)
Schoolyard Heroes - The Last Man On Earth
The Hokum Boys - Ain't Goin' To Beg You For That Stuff
Warrant - All Night Long
Cass Fox - Army Of One
When Dinosaurs Ruled The Earth - Glee Club
Kurtis Blow - I'm Chillin
Malina - Shagi po bitomu steklu
Headhunter - Signs Of Insanity
Amil - Anyday
Beenie Man - Million Gal
Swallow The Sun - ...and Heavens Cried Blood
Sal Mineo - Start Moving
Jesse Malin - Almost Grown
Asleep At The Wheel - The Letter That Johnny Walker Read
Eddie Cano - It Only Takes A Moment (Album Version)
M.A. Numminen - LAIVAMATKA WC:SSÄ
Moon Mullican - New Milk Cow Blues
Enrique Iglesias - Si Juras Regresar
Through the Eyes of the Dead - Outro
Los Amigos Invisibles - Nerio Compra Una Contestadora
Diego Vasallo - Dos imposibles
Radiohead - Vegetable (Live)
Jim Kweskin - When I Was A Cowboy (Western Plains) (LP Version)
Phil Collins - Dance Into The Light (LP Version)
Pyranja - Anfang Vom Ende
Francis Lai - 13 jours en France
F.I.R. - Si Xin De Li You
Milo - Back Into Business
Robin Fox - It's Gonna Be Okay (Original Mix)
Brand X - Zero Db (drum solo by Frank Katz)
Spoonie Gee - Spoonie Is Back
Fastball - No Return (Album Version)
Thrice - Alchemy Index Vol 1 Water 1 of 6
Mercedes Castro - El Cara Bonita
The Fureys - The Anniversary Waltz
Zombie Girl - I Want It
Lou Reed - Intro
R. Carlos Nakai - Blood Round Dance Song (World)
30 Seconds To Mars - End Of The Beginning
Dave Graney & Clare Moore - You Put a Spell on Me
Cama - Fade Away
Rick Astley - Never Gonna Give You Up
OV7 - Volvere
Los Auténticos Decadentes - El Gran Señor
La 5A Estacion - Contigo Si
Pacha Massive - Drive
Kzss & Atma - Obsidian Sunrise
Butthole Surfers - Barking Dogs (From "Piouhgd")
Play - In My Mind (Remix)
Fontella Bass - Rescue Me
The Ataris - The Hero Dies in This One
Hank Locklin - Send Me The Pillow You Dream On
Life Long Tragedy - Collecting Dust
Mario Telles - Nanã
Jennifer Lopez - Play
Cauda Pavonis - Juggernaut
Raphaël - Le Petit Train (Mixé Par Mark Plati)
Mötley Crüe - Merry-Go-Round
The Moody Blues - Long Summer Days
Curtis Mayfield - Soul Music (ReMastered)
Malkit Singh - Mana Laina Chahida
Pery Ribeiro - Piano E Viola
Loretta Lynn - Away in a Manger
Leon Russell - Out In The Woods
Ndala Kasheba - Marashi Ya Pemba
Frankie Randall - Rudolph The Red Nosed Reindeer
Carl Belew - Love's Been Good To Me
Mons Leidvin Takle - Drømmen Om Deg
Bill Laswell - Don't Lose Control
Rocket From The Tombs - Frustration
The Nightraver & The Magican - Drop the Bass
The Strokes - Between Love & Hate
Nirvana - Heart-Shaped Box
Nestor Torres - Rhumboso
Mirah - Apples in the Trees (Live)
Dancecore Allstars - When The Sun Comes Out
Los Auténticos Decadentes - El Chorro
Commissioned - I'm Gonna Let My Love Flow
Crabby Appleton - Go Back
Joy Division - The Sound Of Music - [High Wycombe Town Hall Live 13 July 1979] (Sound Check)
Ray Charles - Let's Go
Alexander O'Neal - Unbreak My Heart
Sui Generis - Cuando Ya Me Empiece A Quedar Solo
Diesel Boy - Dragonfly
