The Grease Band - Willie And The Pig
The Sensational Alex Harvey Band - Framed
Seal - Killer (Single Version)
Be Bop Deluxe - Piece Of Mine
Busdriver - Unsafe Sextet/Gilded Hearts of Booklovers
Ayo - Complain
Hacken Lee - He Jiu Bi Hun
Big Mama Thornton with Kansas Bill and his Orchestra - Hound Dog
Slim Whitman - Cattle Call
Miossec - Que Devient Ton Poing Quand Tu Tends Les Doigts
Los Munequitos de Matanzas - El Chisme De La Cuchara
Perez Prado_ His Orchestra - Abril en Portugal
Hot Tuna - Hesitation Blues
Jenney - Ich vermiss dich (Radio Mix)
Epidemic - Catalyst (LP Version)
Christie Hennessy - Roll Back The Clouds
Clannad - Cumha Eoghain Rua Ui Neill (Lament For Owen Roe)
Inspiral Carpets - Keep The Circle Around
Porcupine Tree - Strip The Soul (album version)
Lightnin' Hopkins - Everyday I Have The Blues
Sonora Santanera - Saca La Botella
YGGDRASIL - Nordfjorloftet
Reel Big Fish - Why Do All Girls Think They're Fat (Album)
Alturas - Turu wilakuy
Andy Russell - I Love You And You Love Me
The Paul Butterfield Blues Band - Pretty Woman (LP Version)
Diego Verdaguer - Todos mentimos
Jonny Lang - One Person At A Time
Steve Vai - Brother
Jacques Dutronc - L'Homme De Paille
Line Renaud - Il Y A Des Anges
Aerosmith - Angel
Gloria Lasso - Que Cosas_ Que Cosas
Sao Paris - Jap
Charlie Byrd Trio - Goody Goody
David Guetta - Joachim Garraud - Chris Willis - Love Is Gone (Eddie Thoneick's Liberte Mix)
Jope Ruonansuu - Rant Kanaria
Porter Wagoner - I Can't Be Your Man
Mel Blanc - I Love Me (I'm Wild About Myself) (2005 Digital Remaster)
Xzibit - Loud & Clear (featuring Defari_ King T & Butch Cassidy)
Theodor Zox - System of Play
Hassan Annouri feat. Cassandra Steen - Wahrheit
Simply Red - A Song For You (Live)
Mitch Ryder - Jenny Take a Ride
Johnny Pearson - Lets Go Amigos - Tail
Iggy Pop - Lust for life (recorded during the us tour in 1986)
Plump DJs - Weighed Down
The Winans - Everything You Touch Is a Song
Murphy Lee / Zee - Murphy Lee
Rocky Hill - Fool For You
Pierre Boulez - Pli Selon Pli ("fold according to fold")/IV.  Improvisation sur Mallarmé III
Gonzalo Rubalcaba - Peace And Quiet Time
Patrizia Pace/Waltraud Meier/Frank Lopardo/James Morris/Swedish Radio Choir/Stockholm Chamber Choir/Berliner Philharmoniker/Riccardo Muti - Mass No. 19 in D minor_ 'Requiem' K626: Lacrimosa
Prince - She Spoke 2 Me ( Extended Remix LP Version)
Converge - Dark Horse
Ocho y Media - A la Hora
Arturo Sandoval - Waheera
Josie - Heavy Heart (Album Version)
Bamberg Symphony Orchestra and Hans Swarowsky - Hungarian Dances_ WoO 1: No. 12 in D Minor: Presto
Tree - Proletariat
Dropkick Murphys - Bloody Pig Pile (Live)
Memphis Minnie - My Butcher Man
Suzi Quatro - Don't Break My Heart
Rainer Bielfeldt - Gewisse Leute
Eugene McDaniels - Headless Heroes (LP Version)
Selena - El Chico Del Apartamento 512
Extreme - Stop The World
Endres - born again
Mobb Deep - (The Grave Prelude)
Hot Tuna - Parchman Farm
Alain Morisod - Besame Mucho
Ghost Machine - What You Made Me (Ugli)
Stockhausen Waterman - String 'Em Up
Bad Brains - God Of Love (Album Version)
RyanDan - Wind Beneath My Wings
Jo-El Sonnier - Precious Lord_ Take My Hand
Mathey - Ballo
Kaija Koo - Savu hälvenee
Bryan Ferry - Don't Worry Baby (1999 Digital Remaster)
Dead Kennedys - Halloween
Paul Cantelon - Mary In Labor
KALIMBA - No Volveras A Mi
Roger Miller - Husbands And Wives
John Holt - The Tide Is High - Original
Sylver - Sympathy
Delbert McClinton - Lover In Demand
The Cate Brothers - Let's Start All Over
Reach 454 - 6 Yrs (Album Version )
The Frequency - Ego is the drug/3am
Word - Il rosso
Spitfire - Feverish
Twila Paris - We Will Glorify (Key-B-Db-Premiere Performance Plus)
Deodato - Groovitation (Album Version)
Fun Lovin' Criminals - Love Unlimited (Explicit)
Prince - Escape ( LP Version)
Sick Of It All - Burn 'Em Down (LP Version)
Linkin Park - Given Up (Album Version)
Socialburn - Everyone (LP Version)
True Believers - Just Look At the Blessing
Beenie Man - Cross The Bridge
Patti Smith - Lo and Beholden
Cece Winans - Life
Commander Cody And His Lost Planet Airmen - Too Much Fun
Tammy Wynette - I Stayed Long Enough
Charlie Peacock - Night Won't Last Forever_ The (Kingdom Come Album Version)
Vivian - Celebration
Dorothy Norwood - Grace And Mercy Part II
Mario Rosenstock - HUM
Toni Braxton - Let Me Show You The Way (Out)
Janis Joplin - Piece Of My Heart
Alexandre Desplat - White Sand
Mink DeVille - Heaven Stood Still
Soul Embraced - Someday (Immune Album Version)
Elizete Cardoso - Cancáo Do Amor Demais
Furry Lewis - Everybody's Blues
La Bergère - (Et puis) Elle allait
Naughty By Nature - Ring The Alarm
Leon Berry - Waltzing Matilda
Bob Cheevers - Memphis Til' Monday
impulsonic - Beats are my Weapons
Los Chunguitos - La Medalla
Bacilos - Sangre americana
The Mars Volta - Eriatarka
Undertakin' Daddies - Two Wheels In the Ditch
Sweet - Neon Psychedelia
The Forms - Red Gun
Azukx - Lift (Joi Blarneyformasian)
Ronnie Milsap - How Great Thou Art
Little Freddie King - Goin' Upstairs (Little Freddie King)
Moonspell - Trebraruna
Mal De Ojo - Lekeitio
Jane's Addiction - Standing In The Shower... Thinking ( LP Version )
Flowin Immo et Les Freaqz - Immonumental
Los Del Sol - Club Tropicana
H-Town - Sex Dance
Ill Nino - Nothing's Clear (Album Version)
Wyclef Jean - Guantanamera
The Cat's Miaow - Autumn
Tania Maria - Come With Me
Jacky Cheung - Zhui Zhong
The Ataris - Secret Handshakes
Bobby Pulido - La Rosa (Live)
Alfredo Gutiérrez - Dos Mujeres
Vulture Industries - The Benevolent Path
Pacha Massive - Don't let go
Alexander O'Neal - When A Man Loves A Woman
Daddy Dog - Bluesanova
John Stewart - Price Of The Fire
Dan Hicks - He Don't Care (He's Stoned)
M83 - You Appearing
Milan Band - Ciao Milan
Soular - Everything Changes
Siouxsie - Into A Swan
Eleanor McEvoy - Please Heart_ You're Killing Me
Bryan Ferry - Slave To Love (7" Version) (2009 Digital Remaster)
Nichols - Fica ma mi
Singing Melody - You're All I Need
Angel Romero / The Academy of St. Martin in the Fields / Iona Brown - Largo
Leaders Of The New School - Zearocks (LP Version)
D:Fuse vs The Scumfrog - Stereo + Video
Caballo Dorado - Me vuelves loco
The London Pops Orchestra - Smile
Gym Class Heroes - Sloppy Love Jingle_ Pt. 3 (Amended Album Version)
Clarence Fountain - Beams Of Heaven
Jeff And Sheri Easter - A Love That Keeps On Giving (Silent Witness Album Version)
Jim Breuer - Party In The Stomach (LP Version)
John Tchicai - Rainbow Dance
The Strokes - Between Love & Hate
Arco Iris - Felicidades
The Sonics_ Charlie & The Tunas - Brown Eyed Girl
Buddy Johnson - Because - Part 1
Ray Barretto - Whirlpool (LP Version)
Samy Deluxe - Die Meisten
False Prophets - Banana Split Republic
Memphis Minnie - Nothing In Rambling
Sunscreem - Exodus
Los Indios Tabajaras - Sueño Salvaje
Danny Wright - Holly & The Ivy (Album Version)
Ben E. King - Love Is Gonna Get You
The Jordanaires - Your Love Takes Good Care Of Me
Hard Romantic - Romanza
Crazy Horse - Dirty_ Dirty  (Album Version)
Aswad - Your Recipe
David Tao - Susan Said
Camp Lo - Baby Mama
Rainbow - Can't Happen Here
Wilks - Psalm 27
Beres Hammond - Missing You For A Mile
Dusminguet - Disco Jonki
Bob Margolin - No Consolation
Aeoliah - For Your Passion My Love
The Jeremy Spencer Band - Travellin' (Album Version)
Carlos Baute - Angelito (Directo 09)
Michael Jackson - Tabloid Junkie
Daath - Above Lucium (LP Version)
George Harrison - All Things Must Pass (2009 Digital Remaster)
Enrique Iglesias - Dicen Por Ahi
Architecture In Helsinki - Heart it Races (Frank Tetaz Remix)
Alain Turban - L'Homme au trapèze volant
Buzzcocks - Get On Our Own
You Should Go Ahead - Losing track
Planxty - Junior Crehan's Favourite - Corney Is Coming
2 Minutos - Tema De Adrian
Little Angels - The First Cut Is The Deepest
Taking Dawn - Black Diamond
Irini Merkouri - Oute Mia Fora
Bill & Gloria Gaither - Holy Ground (Homecoming Hymns Version)
Showbread - Dinosaur Bones
Led Zeppelin - Poor Tom (Album Version)
Sleepy John Estes - Lawyer Clark Blues
Tony Joe White - A Man Can Only Stand Just So Much Pain (Bonus Track)
Roy Rogers - The Yellow Rose Of Texas
Dora The Explorer - ABC (The Alphabet Song)
Johnny Cash - You Tell Me
Faithless - Salva Mea
John Hammond - I Can't Be Satisfied
Modern Lovers - She cracked
Les Ogres De Barback - Grand-mère
Flor Silvestre - Luna De Octubre
George Harrison - Baltimore Oriole (2004 Digital Remaster)
Lloyd Banks - South Side Story
Hank Locklin - (Sittin') Alone At A Table For Two
The Jackson Southernaires - It's All In The Word
Lou Ann Barton - Please Come Home For Christmas
Ray Lynch - Kathleen's Song / Ray Lynch
Whitney Cummings - Romance
Dora The Explorer - Tenemos Amigos
Utopia - The Up
David Taylor - Concertino for Bass Trombone and Trombone Choir
Christian Quast - Jugglin' Clown
Michael McDonald - Losin' End (LP Version)
Black Flag - Room 13
Ice - Shining
Hassan Annouri - Gutes Mädchen
Wednesday 13's Frankenstein Drag Queens From Planet 13 - Plan 9 From Outer Space (Album Version)
Françoise Hardy - Maurane - La Rue Du Babouin
Albin Myers - BOOM!!!
The In Crowd / Jah Stitch - Baby My Love
Imiskoubria - Ine Mono Ekloges
Van Halen - Can't Stop Lovin' You (Remastered Album Version)
Kenny G - Don't Make Me Wait For Love
Maria Callas/Giuseppe di Stefano/Ettore Bastianini/Silvana Zanolli/Luisa Mandelli/Giuseppe Zampieri/Arturo La Porta/Antonio Zerbini/Silvio Maionica/Coro e Orchestra del Teatro alla Scala_ Milano/Carlo Maria Giulini - La Traviata - highlights (1990 Digital Remaster): Ah_ non più (Alfredo/Violetta)
Thrice - All That's Left
Gene Autry - Half As Much
Borialis - Can't Break This Man
Ghorwane - Nudez
Avril - The Matter With You (Part I_ Ii_ Iii)
AFI - Too Shy To Scream
Petra - More Power To Ya
Cavo - Over Again (Album Version)
Red Hot Chili Peppers - The Greeting Song (Album Version)
Brent Lamb - One About Heaven
DJ Clue / P. Diddy - Intro
Taint - Hex Breaker
The Roches - We Three Kings
Quincy Jones - Stormy Weather
Maurane - Juste Une Petite Fille
The Fabulous Thunderbirds - When I Get Home
Eddie Cano - Barsanova Brown (Album Version)
Head Horny's - Pray (Instrumental Version)
Mark Ashley - Operation Love
Alexander O'Neal - Secret Lovers (Featuring Mica Paris)
Madonna - Celebration [Felguk Love Remix]
Rancid - Meteor Of War (Album Version)
Nana Mouskouri - Only You
Francis Lai - 13 jours en France
Sergio Mendes - Tem Do de Mim (Live At El Matador_ San Francisco)
Richie Ray & Bobby Cruz - El Gallo Y La Vaca
Mystic Revelation of Rastafari - Ethiopian Serenade
Johnny Osbourne - Mine Yuh Business
Megadrums - Tschung Mori
Frl.Menke - Sehnsuchtsexpress
Flamin' Groovies - Call Me Lightning
Dylan Kuo - Ji Xiang Yan Chu
Cursed - Pariah
Ram Squad - Dirty South
Phil Collins - That's What You Said  (LP Version)
Agnostic Front - Undertow
Pablo Montero - Jarabe De Pico
Lil Wayne - Fly Talkin'
Dale Hawkins - Pretty Little Thing
Dale Russ / Finn MacGinty - Reels: Old Joes / the Cliffs of Moher / the clips of mohair / the slightly less-well-informed maid
A Challenge Of Honour - Heiliges Feuer
Dora The Explorer - Boots The Monkey!
System of a Down - Streamline
Unwritten Law - Because Of You (Album Version)
Vusi Mahlasela - Miyela Afrika
Singing Melody - All They Want
Stevie Ray Vaughan And Double Trouble - Come On (Pt. III)
Joy Division - Transmission - [The Factory_ Manchester Live 11 April 1980]
Taking Back Sunday - You Know How I Do [Live From Bamboozle]
Billy Higgins - Peace
Usher - Moving Mountains
Rodney O & Joe Cooley - Nutty Block
Monique Marvez - No Bad Oral Sex / Dick Dessert
Carolyn Arends - Last Thursday (Call Me Crazy)
Static-X - Love Dump (Demo Version)
Facto Delafe y las flores azules - Enero en la playa (Edit)
Stevie Ray Vaughan - Crossfire
DJ Nasty - Do It
