David & Steve Gordon - Evenglow
Trafik - Disco Trafiko
Bruisers - Never Fall
Buzzcocks - Strange Thing
Esperanza Spalding / Leo Genovese - Love In Time
ÄI-TIEM - Zeit für Streit
João Gilberto / Gilberto Gil / Caetano Veloso - Cordeiro De Nana
Crusaders - She's My Woman
Roommate - Isn't Radio
K-OS - Sunday Morning (Sony Connect Set)
Roger Williams - Cool Water
Nightwish - Lappi Pt IV Etiäinen
Iggy Pop - Main Street Eyes
The Knightsbridge Strings - Mood Indigo
Jean Lumière - Je suis le passeur du printemps
Abbott & Chambers - Where Are You
Triana Pura - Afonsina y el mar
The Shirrows - Jenny Jenny
The Chi Lites - Toby
Oesch's die Dritten - Die berüehmte drü Wörtli
Commander Cody And His Lost Planet Airmen - Hawaii Blues (Album Version)
AFI - Summer Shudder
OutKast - Happy Valentine's Day
Hevia - San Xuan
Gloria Lasso - Magali
Milan Band - Ciao Milan
Blink-182 - A New Hope
Audio Pyper - Walk in the Park
Soular - Everything Changes
Lizzy Borden - There Will Be Blood Tonight
Casiotone For The Painfully Alone - Bad People
Michelle Tumes - Everywhere (Dream Album Version)
Non Phixion - Sleepwalkers
Rihanna - Good Girl Gone Bad
The Wes Montgomery Trio - Satin Doll
fIREHOSE - Towin' The Line
Beyoncé - Dangerously In Love Medley
Flame - Don't Stop
Joe Turner - Midnight Cannonball (LP Version)
Diesel Boy - Cooler Than You
Michael Bloomfield - Have Thine Own Way
Bob Wills - Sittin' On Top of the Wolrd
Berlin - Blink Of An Eye (Alternative)
Evergreen Terrace - Look Up At The Stars And You're Gone
Cauda Pavonis - Juggernaut
Agnostic Front - Undertow
U2 - Vertigo
K's Choice - A Sound That Only You Can Hear
Sister Hazel - Space Between Us (Album Version)
Monster Magnet - CNN War Theme
Righteous Brothers - Little Latin Lupe Lu
Airto Moreira - Hala_ Tumba And Timbal
The Steeles - Left Behind
Telecast - Covered (The Beauty Of Simplicity Album Version)
The Tragically Hip - The Drop-Off
Bobby Hutcherson - Recorda-Me
The Perrys - I'm Living In Canaan Now
John Mellencamp - Down And Out In Paradise
Frl.Menke - Sehnsuchtsexpress
Ultra X - Break Em
Talvin Singh - Traveller
EPMD - For My People
Mississippi John Hurt - Coffee Blues
45 Grave - Surf Bat (Album Version)
Billie Jo Spears - Permanently Lonely
Mike Bloomfield - Junko partner
The Abominable Iron Sloth - Sailing To The Edge Of The Earth
John Hammond - Ain't That Loving You Baby
Los Originales De San Juan - Con La Misma Tijera
Julie Roberts - Unlove Me
Rage Against The Machine - Kick Out The Jams
Los Auténticos Decadentes - El Chorro
Nicho Hinojosa - Tomame O Dejame
The Del McCoury Band - Led By the Master's Hand
Mil - Dis moi
The Cate Brothers - Please No More
Black Eyed Peas - Let's Get It Started
Sane Band - Thats life
Stephen Warbeck - Birth Of The Falls
Hatebreed (int License) - Between Hell and A Heartbeat [Explicit]
Owsley - Class Clown/Good Old Days (Reprise)
R. Carlos Nakai - God Rest Ye Merry Gentlemen (World)
Anane - Let's Get High (Yves Larock Radio Edit w Rap)
Tora Tora - That's Not the Way Love's Supposed to Be
Missy Higgins - Ten Days (Album Version)
Paul Avgerinos - In My Heart
Organ Donors - Tranceplant
Adam Richmond - Pic & Run
Sun Yan-Zi - Abscondence
Del The Funky Homosapien - Corner Story
Doyle Bramhall - Chateau Strut
Twenty 4 Seven - You Gotta Be Safe
Mathey - Ballo
The Shamen - Heal (The Separation) [PM Dawn Alt. Lead Mix]
Claw Hammer - Speak Softly
Gorillaz - White Light
Cândido - Sentimentos Desiguais
Guns N' Roses - Patience
María Elena Walsh - Balada De La Mariposa
Trivium - Upon The Shores [Explicit]
Blingtones - Torero
Edmundo Ros & His Orchestra - Mélodie d'Amour
Eldar - Dat Dere
Gabriel Grossi - Cai dentro
Pee Wee King - Where Were You Last Night
K.I.Z. - Autofokus
Emilio - Somebody Stop Me
Mindy McCready - Ten Thousand Angels
Washboard Sam - The Gal I Love
Hank Locklin - Rio Grande Waltz
Wednesday 13's Frankenstein Drag Queens From Planet 13 - Plan 9 From Outer Space (Album Version)
Ricky Martin Feat. La Mari de "Chambao - Tu Recuerdo
Skeeter Davis - Foggy Mountain Top
Non Stop DJs - Hydraulic Pimp
The Ataris - Whatever Lies Will Help You Rest
Margaret Becker - Sweet Suffering Christ
Bomb Squad - Flipside
Plump DJs - Creepshow Remixes (Soul Of Man Mix)
Les Rythmes Digitales feat. Nik Kershaw - Sometimes
Willie Clayton - Unconditionally (Soul and R&B)
Camp Lo - Uptown
Captain Hollywood Project - All I Want
Ill Harmonics - Life
The Impressions - You'll Never Find
Mario Rosenstock - Fast Eddie
Glen Washington - Number One Girl
ARRESTED DEVELOPMENT - Greener
Rocky Hill - Hootchie Cootchie Man
Der Plan - Was Ich Von Mir Denke
The Stolen Minks - I Hate You
Sasha - Who Killed Sparky?
Bülent Ceylan - Bülent & Mompfreed: Mompfreedonium
Hatebreed - Mark My Words (Album Version)
Johnny Pearson - Purple Haze
Bug Mafia - Poezie De Strada / Street Poetry
Richard Galliano_ Jean-Charles Capon_ Gilles Perrin - Sing Me Softly of the Blues
Silverstein - BLEEDS NO MORE (Live Version)
Ras Michael and the Sons of Negus - Ethiopian Anthem
The Shangri-Las - Remember (Walkin' In the Sand)
Sun Yan-Zi - Sensible
Mick Moloney - Bodhrán Solo
Information Society - Empty
Red Foley - Choc'late Ice Cream Cone
Shelley Fabares - Johnny Loves Me (LP Version)
Webb Wilder - Too Cool for Love
Vodka Collins - See You Comin'
Richie Ray & Bobby Cruz - Bomba Camara
Dj Kun - Spaniolandia
JennyAnyKind - Young Boy Blues
Languis - Cable
Panic! At The Disco - I Constantly Thank God For Esteban (Album Version)
Selena - Ven Conmigo/Perdoname (Live)
Cassius Clay - Round 7:  2138
Britney Spears - Can't Make You Love Me
Back Door Slam - Heavy On My Mind (Album Version)
fIREHOSE - For The Singer Of R.E.M.
Marco Beltrami - Revelations
Rubyhorse - Evergreen
Ragheb Alama - A'chek Ouyounik (2009 Digital Remaster)
Daryl Hall & John Oates - Only Love
Dickies - Gigantor
Orquesta Aragón - Mambo del Beso
The Fool'S Nose - The Last Song
Vana - Village Dance
The Scare - I Saw Destruction
Primordial - The Burning Season (Live)
Tex Williams - Wild Card
Wild Horses - Let It Bleed
Ashton Shepherd - Sounds So Good
Estrellas Cubanas - Fiel Enamorado
Steve Smith - Blue Cave
Lara Fabian - Ramène Moi
Raze - Always And Forever (Bff)  (Power Album Version)
Michael Jackson - We're Almost There
Off Broadway - Bully Bully (LP Version)
Lorna - Papi Chulo (Extended Mix)
Jerry Reed - When You're Hot_ You're Hot
Carl Smith - Hey Joe
Enter the Haggis - Skyswimmer
Russ Morgan - The Moon Was Yellow
Jeanie Lambe & The Danny Moss Quartet - My Funny Valentine
Elvira - Momentum
Irini Merkouri - Ela Edo Kardia Mou
Voyager Series - The Harp That Once Through Tara's Halls
fIREHOSE - Rhymin' Spielin'
Bill & Gloria Gaither - Awesome God
Ziggy Marley And The Melody Makers - New Love
Mack and Jamie - Goofy Golf
Gus Cannon - Big Railroad Blues
Marcel Azzola - Mon Legionnaire
Drop Dead_ Gorgeous - Are You Happy (Album Version)
Mish Mash - Kolomeyke
Ray Lynch - Kathleen's Song / Ray Lynch
Pe'z - Spirit
Jessica Simpson - Be
Jimmy Johnson - Country Preacher
Elliot Goldenthal - Pickled Heads
Schizoid - Grim Prospects (Harsh Remix)
Wednesday 13 - Haunt Me (Album Version)
Beastie Boys - Get It Together
Soda Stereo - Persiana Americana (Live)
Little Eva - Up On The Roof (LP Version)
Chroma Key - Salvation
John P. Kee - Encouraged
Hot Club Of Cowtown - The Magic Violin
Dwayne_ Gyptian - Rudeboy Shuffling
Mademoiselle Sane - La petite boite en fer
Arthur Fiedler;Earl Wild;Pasquale Cardillo - Rhapsody In Blue
Bob Margolin - No Consolation
Jim Reeves - Jingle Bells
Five Fingers of Funk - Genuine
The Sonics - On The Road Again
Lambda - Hold On Tight
Dimmu Borgir - Master Of Disharmony
Vangelis - Procession
El Gran Silencio - Ayer
Danielle Bollinger - Kiss the Sky
The Irish Tenors - The Croppy Boy
The Knife - The Captain
Leon Russell - Out In The Woods
Chris Farlowe - Blues As Blues Can Get
Marcelo Radulovich - Non-Stop Floater
ARRESTED DEVELOPMENT - Natural (2002 Digital Remaster)
Winston Reedy - Sentimental Man
Myrick "Freeze" Guillory - Zydeco In D-Minor
John Stewart - Wild Horse Road  (LP Version)
4 Skins - A.C.A.B. (Bumper Sessions)
The Shangri-Las - Out in the Streets
Dilated Peoples Featuring Black Thought - Hard Hitters
Richard Burton - I See The Boys Of Summer
Ethel Merman - Small World
Simon & Garfunkel - Patterns
Aceyalone - Suicide
Madonna - Vogue [Live]
Warren Barfield - Unleashed
Tony Matterhorn - Dutty Wine
Charles Williams - From the East
Channel Live - Turn It Up
Sugar Minott - Mash Up Mi Life
Arsonists Get All The Girls - Violence in Fluid Triceratops
Vince Guaraldi / Bola Sete - Choro
George Dalaras - Ammohostos
Wet Wet Wet - Hear Me Now
Creedence Clearwater Revived - Have You Ever Seen The Rain
Alex Fong - Hao Lai Hao Qu
Gene Chandler - Festival Of Love
Robert Palmer - Some Guys Have All The Luck
Goldfish - Tracy
Thomas Dolby - Dissidents (The Search For Truth Part 1) (2009 Digital Remaster)
Helen Love - Rollercoasting
Dora The Explorer - ABC (The Alphabet Song)
Jefferson Starship - Fading Lady Light
Casa Bulga - Afraid Of Change (Tribal Vocal Mix)
Tito Allen - Nadie Como Tu
AUDIO.3 - SPONT.AN
John Fogerty - Don't You Wish It Was True
Gaither Vocal Band - Little Is Much When God Is In It (South African Homecoming Album Version)
Casiotone For The Painfully Alone - Happy Mother's Day
Mike Jones - Grandma (Screwed & Chopped Version)
Deftones - Lotion (LP Version)
Nino Nardini - Bumbling Along
Loop Guru - Climax
Fania All Stars - Donde
Joy Division - Digital [Live at Birmingham University] [2007 Re-mastered]
True Believers - Stranger
Olivia Ruiz - Vitrier
Bon Jovi - Wildflower
Cam'Ron - I'm A Chicken Head (Skit)
Jazz Gillum - You're Laughing Now
Les Malpolis - Les Psys
Los Del Rio - Macarena
She Satellites - No-Satellites
OutKast - Return Of The "G
La Portuaria - Hasta El Final
Sister Rosetta Tharpe & Marie - Up Above My Head
R. Carlos Nakai - Cedar and Clay (World)
Dario Marianelli - The Harbour
Primordial - Empire Falls
Jay & The Americans - Livin' Above Your Head
Juan Diego Flórez / Mariusz Kwiecen / Orquestra de la Comunitat Valenciana / Daniel Oren - Venti scudi
Clementina De Jesus - Itinerario
Jo Privat - Espoirs Perdus (Valse)
La Billo_ Los Melódicos - Para Que Recordar
Unkle Bob - What Do I Know
Johnny Horton - Go And Wash (Those Dirty Feet)
David Tao - Summer Love Triangle
Ashtrax - Future Traffic Song
Kari Tapio - Syvä meri (Oceano)
Estopa - Apagon
Human Disease - Gold Flames Of Angels
Xcultures - Smile
Heavy D / McGruff - Wanna Be A Player
Myrick "Freeze" Guillory - Queen Ida Introduction
Maurice Larcange - Je T'Appartiens
Jessica Simpson featuring Lil Bow Wow - Irresistible
T.G. Sheppard - Finally (Album Version)
Seamus Egan - Lock The Door / Get Up Old Woman And Shake Yourself / What Ail's You? - (single jig)
Alice In Chains - Would?
Bobby Bland - Drifting From Town To Town
Alan Silvestri - The Joes Mobilize
